F 220,100,0

NO ./textures/north.xpm

C 225,30,0

WE ./textures/west.xpm

SO ./textures/south.xpm

EA ./textures/east.xpm


111111111
100000001
100W00001
100000001
111111111
