NO textures/retro1.xpm
SO textures/retro2.xpm
WE textures/retro3.xpm
EA textures/retro4.xpm

F 0,1,1
C 135,206,235

111
101
101
101
1D1
1D1
1D1
101
1D1
101
1D1
101
1D1
1N1
11111
11101
11111
