NO ./textures/north.xpm
SO ./textures/south.xpm
WE ./textures/west.xpm
EA ./textures/east.xpm
F 0,0,0
C 255,255,255

1111
1E01
1111
