F 220,100,0


C 225,30,0


NO textures/retro1.xpm
SO textures/retro2.xpm
WE textures/retro3.xpm
EA textures/retro4.xpm

111111111
100000001
101N10001
101110001
111111111
