NO textures/retro1.xpm
SO textures/retro2.xpm
WE textures/retro3.xpm
EA textures/retro4.xpm

F 0,1,1
C 135,206,235

11111111111
10000000001
1d10D0d01D1
100000000N1
11111111111
